1) Тестирование ПО - это процесс проверки соответствия работы продукта требованиям и ожидаемым результатам.

2) Этапы SDLC:
	Planning - на этом этапе проиcходит формулирование целей и задач, определение сроков, количество необходимых средств и ресурсов.
	Requirements analysis - на этом этапе проиcходит формирование требований.
	Design - на этом этапе проиcходит выбор технологий, языка программирования, назначение требований к интерфейсу, выбор архитектуры системы. 
	Implementation - на этом этапе проиcходит разработка ПО, создание прототипа и рабочей версии.
	Testing - на этом этапе проиcходит проверка продукта на соответствие требованиям установленным на предыдущих этапах разработки, поиск и регистрация багов.
	Deployment - развертывание продукта в его рабочей среде, эксплуатация.
	Maintenance - поддержка пользователей, исправление дефектов, реализация нового функционала, измененеие существующего.

3) Этапы тестирования:
	Анализ требований - анализ и уточнение требований, определение целей тестирования и приоритетов.
	Планирование тестирования -  оценка объема испытаний и ресурсов.
	Тест-дизайн - написаний тест кейсов, автоматических тестов, подготовка тестовых данных.
	Запуск тестов - выполнение тестов, созданных на этапе тест-дизайна.
	Редактирование тестов (если необходимо) - исправление тестов или актуализация.
	Регрессионное тестирование
	Приемочные испытания - проводится на этапе сдачи готового продукта (или готовой части продукта) заказчику.
	Поддержка и сопровождение - помощь пользователю в эксплуатации продукта.
	Анализ результатов

4) Регрессионное тестирование - тестирование с целью убедиться, что внесенные изменения не повлекли появление дефектов в той части программы, которая не менялась.

5) Смоук тест представляет собой минимальный набор тестов на явные ошибки после сборки кода, т.е. цель - проверить, готов ли продукт к тесту критического пути/расширенному тестированию.

6) Уровни автоматизации тестирования:
	Модульное тестирование - тестирование отдельного модуля.
	Интеграционное тестирование - тестирование программных модулей в группе.
	Системное тестирование - тестирование всей системы.	

7) Основные особенности Agile методологии:
	Частое снабжение клиента ПО
	Гибкость процесса разработки
	Итеративность  
	Инкрементальная разработка
	Самоорганизация команды

8) Характеристики хороших требований:
	Полнота - описаны все важные требования, интересующие пользователя.
	Однозначность - требования могут быть интерпретированы только однозначно.
	Корректность - требования сформулированы исходя из потребностей пользователя.
	Непротиворечивость - набор отдельных требований не должен противоречить другому.
	Необходимость - требования должны быть необходимыми.
	Осуществимость - требования могут быть реализованы.
	Проверяемость - требования должны быть написаны так, чтобы их можно было проверить.
	